11111
10001
10001
10N01
11111
